111113111111
1000C00C001
101110000C1
1P1000000E1
11111111111