11111111111
11111111111
10000C00101
1P0111E1101
11111111111
