11111111111
1C100000101
1010100P001
1P00C00E001
11111111111